33333333322222222222122222332222222222221222444444
33333333222222222222222222322222212222222224444444
33333332222222222222222222222222222212222244444444
33333222222222222222222222212222222222224444444444
33332222222222222222222222332222222222224444344444
33222222222222222222222223333333333222224444444422
22244444443333133111111111433333444444133111112223
22244444433333333111111111333343344443333111111222
22224444433333333311111111133333444433333331111222
22222244332133333311111111133334434333333133111223
33111122222222222333333333333344444444411222222212
31111222222222222333333333333344444444442222222222
22222222333132222222111111222222233333333331313333
22222222322222222222221222212222222333333333333333
22222222222222222222222222222222212233333333333333
22222222222222222222222222222222222222333333333333
22222222222221222222222221222222122222233333333333
22222222222222222222222222222221222121223331333433
22222212221222222221222222222222222222213333333333
22222222222222222212222222222221222212223333333333
33334411111222222222223333333333333332222222222333
33334441122222222222222333333333333332221222223333
23344444422222222222222222333313333332222222333343
33444444422222222212222222233333333322222333133334
33333322222222222233333333332222222222222222222233
33333222112222122223323333333222222222222222222233
33333222221222222223333333333222222222212222222333
33333322222222222233333333333222222222222222222333
33333322222221222233333333333222222222222222223333
22222222222222222233333333333322222221222222223333
22222222222222222233333303333322222222222222233343
22222222221222222233334333333322212222222222233333
22222222222122244433433231334322222222222222223333
12222222224444444443333333333222222222222221222303
22222222244444444444333333322222222222222222222333
22222222244444444344433332222222222222222222222233
22222322224444443444444222222222222222222222222243
22233332224444444444444222222212122222222222222444
22333332222444444444444222222222222222222222222444
13333332222444444443444212222222222222222222214444
