22222212222222222244444444444444444222222122211114
22222222222222222244444444444444444222222222222444
22222222222222222244444444444333333222112222222244
22222221222222222224444444433333333222222222222244
22222212222221122224444443333333313222222222222244
22222222222222222224444433333303333322222222222224
22222222222333313333333333331111112222222222233333
33222222222222222224443333333333333444222212222224
32333222222222222224433333333333334444422222222124
33333344422222222222333333333333344444442222224444
22233333311111111113334333333332233333333313313344
31322222222222111111133333311133343333333322222222
33332222222222111121113111111133333333334332222222
43333331332222222221222222222223333333333433333333
22222222122211333333311111111111130333333303334444
22222222222233333133331114111111133333333333314444
22222222222233333333333111111111333333323331111444
22222222222233333333333311111103333330333111111444
22222322222222222222122222233333333333333333444333
22122222222222222222222222233333433333333333444444
22222222122222222222222222233333333333333334444444
22222222212222222222222222333333333333333344444444
22222222222222222222222222233333333333333444444444
22222222222222221222222222233333333333334444444444
21222221222222222222222222233333333333334444444444
22222222222222222222222222233333333433334444443344
22222222222222222222222222233333333333333444433333
22222222222222222222222222233333333333333441113333
22222222222222222222221222233333333333333111111333
22222222222222222222222222333333333333333111111133
22222222222222222222222223333333333343333331111113
22222222222222222222212233233333333333333333111111
22222221222222222222244442222222223322222222223333
22122222222222222222244422222222334322222222222333
22222222222222222222244222222223333322222222222333
22222222222222222222242222222333333322221222222333
22222222222222222222122222223333333322222222222333
22222222222222222222222222233333333321222222222333
22222222222222222222233333333333333222222222222333
44222222211111122222333333333333333222222222222333
