24444444222222222222122222222212222212222222222222
24444444422222222222222222222222222222222212222222
24444444442222222222221222222222222222222222222222
22444444444112222222222222222222222222221221222222
23333444314111122222222222222222222222222222222222
33333333111111111222232333222222222222221222222222
33333331111113111111113333333222222222222222222222
22222222222444431222222222222232222222222222212222
22222233333333332222222222222222222333333444444444
22222233333333332222222122222222222333333444444444
22222223333333332222222222222222222333343444434444
22222223333343332222222222222222222333344444444444
22222222333333332222222222222222212334444344444444
22222222333333332222222222222222223444444444344344
22222222233333332222222222222222224444444444444444
22222222213333332222222222222222222444444444444444
22222222222223332222222222222222222444444444444444
22221222222222222222222222222222222244444444444344
21111111131333333333222222222233333333333334444444
12222244444442224444442222222221111111111112222222
22222144444441122244212222222221011111111111222222
22222444444412222222222222222222111111111111122222
22224444434332222222222222222222211111111111112222
33333444443333222222222222222222221111111111111222
33333344433333322222222222222222222111111111111122
33333333333333322222222222222222222221111111101122
33343333313333332222222222322222122222111111111222
33333333333333333222222233322222222222211111111222
30333333333333333332222333322222222222221111112222
33333333334333333333333333332222222222222111112222
33344444444444442221111111111111111111121111111122
33344444344444444111111111111112111111111121111222
23333333344443444444422222222222222222222222223333
33433333134444444444222222222222222222222222222333
33333331333344444412222222222222222222222222222333
33333332333333444112122222222222222212222222212233
33333333333343111112222222222222222222222222222222
33333333333333111112222222222222222222222222222222
33333333333331411112222222222222122212222222222222
33343333333331111122222222222222222222222222222222
