22222222222222222222244433333333331322222222222222
22222212222222222333333333333322222222222322222222
22222222222222222222244344333333333322222222222222
23222222222222212233333333222222122222223322333333
33332122222222122233333222222222222222233333333333
33333322222222222233332222222222222222333333333333
33333333333333222233222222222122222223333333333334
33333333333333333312222222222222222233333033333333
33333333333333333332222222222222222333333333333333
33333333330333333112222222222222223333333333334343
33333333333333111122221222212222223333333333333343
11111222222222222222231331333333322222222333333333
33333333111111111122222222222222333333333333333333
11111122222222222222233333333333332222222222222234
11122222222222221222333333333333332222222222222223
11111222222222122222333333333333331122222222222222
23333111111111222221222222233333434333333333333333
11111222222222222244443333333333333222222221222222
11112222222222222444443333333333333222122222222222
33333333333333333333333333322222222222221222222222
11112222222222224434444333333333312222222212222222
33111111111133333333333433322222222222222222222222
22222222222212222444444443333333333322222222222222
22222222222222222244444443333313333322222222222212
33111111111133333333333333222222222221111122222221
31111111111133333333333333222222221111111122222222
22211111111111111112222222222221111111111112122122
22221111111111221112222222222111111111111112221222
22222222222222222222222224144444422221222222222222
22222222211111111111222222221111111111111101222222
22222222211111111111222222211111111111113111222222
22222222211111111111222222211111111112111111222212
22222222222222222222222244444444222222211111111111
22222222222222121222222233444344222222211111111111
22222222221222222222223333334442222222111111111111
42222222222212221222222222222222222222222222444444
12222222222222222222222222222222222222222224444344
22122222222222222122222222222222222122222123444444
22222222222222222222222222222222222222222233444444
22222222212222222222222222221222222212222333344444
