22211111111111111222222222122222222222224444442222
22221111111111122222222212222222222221224444434222
32221111111111222222222222222221212222124444444422
33321111111122222221222222222222122222224444444442
33331111111122222222122222122222222222224444444444
33332222111222222222222222222222122222224444444444
33222221111222222222222222222122222222233444444444
32212221111222222222222222222222222222333444444444
22222221111222122222222222222222222233333344444443
22222211111222222222222222222222222333233334443444
22222211111221222222222222222222223443333333333444
22222211111222222222222222222222233333333333333333
22222211111222222222222222222222133333333433333333
33222111111222222222222222222222222222223333333333
33322111112222221222222222222122122222222333333333
33333311112222222222222221111112222222222333333333
33333331112222222222222221111111222222222333433333
33333341112222222222222221131111212122222333333333
33333333444422222222222211111111122222223333333333
43334333444444422222222211111111122222223433333333
33333334444444422222222211111111122222222333333323
33333344444444442222222211111111122222222333333333
23333344444444442222222211111111122222222234333333
22333444444444433322222211111111122222222233333333
21211444444444334332222111111111122222222223343333
22211144444443333333322111111111122222222223333333
22222223333332222233333322222122222221223323333322
22222333331332222122222222222222122222223333333222
33333333333332222212222222222222222222233333332222
44444333333333222222122223133333133332222224444444
44444433333333222222222223333333333222222222444444
34444433330333222222222223333333322222222222224444
44444433333333222222222233333333222222222222222244
33333433333223333333333333444444422222222222222222
33333333333333333433333434444444222222222222222222
33333333333333333333333344444444222222222222221222
33333333334334333333333344444442222222212122222222
33332233333333333333333434444442222222222222222222
33322223333333333333334444444422222222222222222222
33322223333334333333334444444422222223133333222222
