33224444444433333333333111111111122221222222222222
32222222444333333333333111111011122222122222222222
32222222212222222222221111111111122222222222222222
22222222222222222122221111111111122222222222222222
22222222222222221222211111111111122222222222222222
22222222222222221222111111111111222222222222222222
32122222122222222211111111311122222222222222222222
33321222222222222111111311112222222222222222222222
33333222223322221111111111122222222222222222222222
33333333323312211111111113322222222222222222222222
23333333333333322222222222222132222224433333333333
22222222333333333222222222222222224444221222222222
22222122233333333222222222222222244444422222222222
22222222222333333322222222122222244444411112222222
22222222222233333322222222222222444444341111111222
22222222222233333322222122222222444444441111121113
44222222222222222222222222222222222223433332221222
44222222222222222222222211222222222222333322222222
22222222222222222222222111122222222222233322222222
22222222122222222222221411122222222222223222222222
22222222222222222222221111112222222222211111112222
22222222222222222222211111112222212222221111111111
22222212212222222222112111111222222222241111111111
22222122222222222122222222222122222222222222233333
22222222222122222222222222222222222222222221233333
21222222222222222222222222222222222222222222333333
11111122222222222133333333333332222222222233333333
22222222222222222222222222222222222212333333333333
22222212222222222222222212222222222223333333333333
22222111112111142222222222222232222222233333333222
22222222222222122221211111444444444414333333333311
22222122222222222212221122244444444434333333333331
22222111111114444422222222222333333333333333333322
22222222222222222222222222222222244444333333333333
22122222222222222222222222222222222243333333333333
22222222222212222222222222222222222221333333333333
22222212222222222222122222222122222122333433333333
22222222222222222222222222222222222222343333333333
22222222212221222222122222222222221222233333333333
22222222222222222222222222222222222222233333333333
