22222222233422222222333333333333333322212221222222
22222222213422222222333344333333334322222222222222
22222222233442222222333444333333333322222222222233
22222222333444222222244444333333333322222222222333
22222333333333333333333222221333313332222222223333
22211111144444344444332222222222222222233333333333
22211111144444433333332222222222222222233333333333
22222222222222232222122222333333333333444433313344
22222222122221222222222222233333333333344444433344
21221111333313333333332222222222122222233333333333
22222222222222222222222222222233333333333344444434
22222222222222222222222222222222333433333334444444
22122222221222222222222222222222223333333333444344
22222222222222222222222222222222222333333333333334
32222222222222233333333311111111122222222222333333
11111111113322222222222223333333333332222222222222
21111111113322212222222223343333333332222222222222
21111111112222222222222233333333333332222222222122
21411112222333332222222133333333333332222122222222
33333333222222223333333333333322222222222222233333
33333332222222222333334333333322222222222222133333
33333332222222122333333333333322222222222222233333
33333333122111133433333333333333333222222222222222
33333332222333333334333333333333322122222222222222
33333122222233333333333333333333222222222222222222
33333222222233333343333333333232222222212222222222
33332222222223333433333333313222222222222222222222
33322222222222233333331333332122222222222222222222
33222212222222223333333333322222222222222222221212
33222222212222222313333333322222222222222222222222
33222222222222222223333333222222222222222222222222
33222222222222222222332231222222222222222222222333
33222222222222222222222222222222222222222222222334
44412444222222222222222222222222222222222222223333
44333444442222222221222222222222222222222222223333
44433444444422222222222222222222222222222222223333
22222222333311111114444443333322222221111113333334
24333444344444422222222222221111111222222222333333
22222223333333331113333333333222222221111111333224
43333444444443422222221222221111111111112334333333
