21222222233333332222222233332222222222222222222221
22222222233333332222122233332222222222222222222223
22222222333333333222222333332222222332222222222223
22222123333333333222222223333222233332222221222223
33322223333333333333111111442222222222111113333333
33332222222223333222222222222222114444443433344434
33322222313333333111111122222222222222221333333333
33322222222222222222222222222222244444444444444444
33222222222222211111111112222222222112222333333333
33222222222222222222222212221111114444444344444444
33322222222222111111111112222222222222222333333333
32222222222222222222211111111111114444444444444443
03322222222221111111111112222222222222222233333333
33332211222211111111111112222222222222222233333333
33312222222112111111111122222222222222222211111111
33332222222111111111111122222222222122222111111111
33313322222222222333333333333311111144444433333333
33322244444411111111111322222222222222221111111111
22222222233333333333222222222222222222222222111134
22212222223333333322222222222222222222222223311111
22122224444433333333222222222111121111322222222222
22222222221222222222222222223333333333333333121222
22222222222222222222222222223333333333333331111122
22222221222222222222222223333303333133334331111122
22222222222222222222123333333303333333333311111112
33333333332221222222212213333333333222221111113333
33333333332222222222222223333333323311111111113343
33344443444444442223333333333322222222233333344444
22223333333333333333333334333322222333331111111111
21223333333333333333331333333222222233311111111111
33333444444444222222222222222222222222233333134444
33333344444442222222222222222222222222333333334444
33333334444422222222222222221222222222333313333444
23332333333344441111111222222222223222222222222222
22312133333331111111111222222222222212222222222222
22222111111114443333333333322222222222222222222223
21111133333331111111112222222222222212222222112222
22222211114444443333333331222222222222222222222212
11111133333333111111112222222222212222222222222222
22222222222222221222223332222222222222213322221222
