22222221111444444442222233222222233333333333133333
22222222111143444422222222222222333343333333333333
22222222111111122222122222222223333444333333333333
12222222111111122222222222222233333444433333333333
22222222212111122222222222222333334444444333333333
33222222212222222223331333333333333333333333332222
22222222222222231444443333333333331111111144444222
22212222332222234444443333333333322111110134444222
22222222332322224444442221222222222221111444444333
33332222222223333333333222222212233333333333333222
33333322222223333333333222222222224333333333333222
33333322222223333333312222222222244444444333333222
33333332212223333333332222222222244444444444442222
33333332222223333333332222222222244444444444442222
33334333222223333333332222221222244444444444442222
33333333222223333333322222222222244444444444442222
43333343222223333333322222222222444444444444342222
43333333322223334333322222222222444444444444442221
43333333322223333333322222222222444444444444442212
33333333332223333333322222222222444444444344442222
33333333332223133333222212222224444444444444442222
33333333333333334444444422122223333333333334333333
33333333333333334444444422222123333333343333332223
33333333333333334444444422222223333333343334322223
33333222333333344444444422222222222222333333222222
30322222223333344444444422222222222222222332222222
33222122222222224444444222221222222222222222222222
32222222212222222444444222112222222222222222222222
22222222222222222244441222222122222222222222221222
22222222222222221334442221222222222222221312222122
22222122222222233333342222222221222222333322222222
22222222222222333333332222222222222233333322222222
33333331222222222222222222222222223333333333322222
22222222222222222222222222222212233333333333222222
22222222222221222212222222222222233334444443222222
22222222222122222222222222222222444444444444222222
22222222222222122222222222322224444444444444222222
22222122222212222222122223333333344444444444212222
22222222222122222222222233333333434444444434333332
22222222222222222222222233333333344444444444333333
