33333333322222222221222222222221222212222222222222
33333333222222222222222222222222221221222222222444
33333333222222222212222222122222222222222244444444
33333333222222222222222222222221222222222333444444
33333332222222222222222222222222222222223334444444
22221111111111222222333333322222221214444443333333
33333332222222222222222222222122222223333333444444
22221111111111112222333333333333321111122222222222
22221111111111111223433333333313331111112222222222
22222211211111111133333333333333311111111222221222
22222222211111111333333333333433311111111222222222
22222222222111111333333333333334311111111122222222
22222222222222113333333343333333311110111111222222
22222222222222223333333333333233311111111111112222
22222222222222233333333333333333311111111111111222
22222222222222233333333333333333111111111111111122
11111111133313322224444444444444411133333333333333
22222222222222233333333333333433111111111111111112
22222222222212222222444433333333434433333333332222
22222222222212222222444444334333444333333311122222
22222222212222222233333033333333111111111111111111
33333333333333322333333311113333332222222233333344
22222222222222222122233333333332221111111111111333
22222222221222222222223333313322222222111111133333
22222222222222222222222333333222222222222113333333
22222222222222222222222234332222222222212233333333
22222222222222122222222213332222222222222233333333
22222222222122222222222222322222222222222233333333
33323222222221222222222222222222222222222113333333
33333222222222222222222222212222222222222111133333
33333222222222222222222222222222222222221111112343
23333333322222222222222222221111111222222222223333
33333222222233333322222222222222222222211111112222
33333333332222221222222122213323141111122222212333
33333333332222222222222222223333311111112222113333
13333303332222222222122222233333311111111222233333
22222211111111111122222212222222222222222222433333
33333333222222222222222222233333331111111113333333
33333332222222222222222212223333331111111113333333
33313333333333322222222222222222222222222222222222
